88
0100000000000002
0000000303000000
0000030303030000
0001000000000000
0000030303000200
0000030303030000
0000000303000000
0100000000000002